       #####
########   ####
#P    B       #
#    OB    O  #
# B      BB B #
# BOBBB     GG#
#    u      BG#
###############